111111111
100000001
1000E0001
1000000C1
100100001
110000001
100000101
100000011
100000001
110100001
10000C001
100000001
1010000P1
111111111